"filename", "language", "Python", "Markdown", "JSON", "comment", "blank", "total"
"c:\Users\heave\Documents\GitHub\Computer-Science-30-Captsone-Project\Documentation\Project Proposal.md", "Markdown", 0, 22, 0, 0, 3, 25
"c:\Users\heave\Documents\GitHub\Computer-Science-30-Captsone-Project\Documentation\Version Roadmap.md", "Markdown", 0, 15, 0, 0, 7, 22
"c:\Users\heave\Documents\GitHub\Computer-Science-30-Captsone-Project\Documentation\changelog.md", "Markdown", 0, 8, 0, 0, 1, 9
"c:\Users\heave\Documents\GitHub\Computer-Science-30-Captsone-Project\Documentation\file system.md", "Markdown", 0, 54, 0, 0, 1, 55
"c:\Users\heave\Documents\GitHub\Computer-Science-30-Captsone-Project\Game\Archive\Weapons_Menu.py", "Python", 41, 0, 0, 5, 12, 58
"c:\Users\heave\Documents\GitHub\Computer-Science-30-Captsone-Project\Game\Classes\planet_class.py", "Python", 46, 0, 0, 7, 20, 73
"c:\Users\heave\Documents\GitHub\Computer-Science-30-Captsone-Project\Game\Classes\player_class.py", "Python", 84, 0, 0, 15, 19, 118
"c:\Users\heave\Documents\GitHub\Computer-Science-30-Captsone-Project\Game\Controllers\Event_Controller.py", "Python", 39, 0, 0, 3, 13, 55
"c:\Users\heave\Documents\GitHub\Computer-Science-30-Captsone-Project\Game\Controllers\Menu_Controller.py", "Python", 35, 0, 0, 6, 10, 51
"c:\Users\heave\Documents\GitHub\Computer-Science-30-Captsone-Project\Game\Controllers\Planet_Controller.py", "Python", 23, 0, 0, 4, 8, 35
"c:\Users\heave\Documents\GitHub\Computer-Science-30-Captsone-Project\Game\Controllers\Player_Controller.py", "Python", 44, 0, 0, 1, 4, 49
"c:\Users\heave\Documents\GitHub\Computer-Science-30-Captsone-Project\Game\Data\Data_Files\Ore_Data.py", "Python", 34, 0, 0, 0, 3, 37
"c:\Users\heave\Documents\GitHub\Computer-Science-30-Captsone-Project\Game\Data\Data_Files\Planet_Data\Earth_Data.py", "Python", 71, 0, 0, 0, 12, 83
"c:\Users\heave\Documents\GitHub\Computer-Science-30-Captsone-Project\Game\Data\Data_Files\Planet_Data\Mars_Data.py", "Python", 54, 0, 0, 0, 3, 57
"c:\Users\heave\Documents\GitHub\Computer-Science-30-Captsone-Project\Game\Data\Data_Files\Player_Data.py", "Python", 51, 0, 0, 6, 8, 65
"c:\Users\heave\Documents\GitHub\Computer-Science-30-Captsone-Project\Game\Modules\Events\Alien_Event.py", "Python", 79, 0, 0, 6, 22, 107
"c:\Users\heave\Documents\GitHub\Computer-Science-30-Captsone-Project\Game\Modules\Events\Pirate_Event.py", "Python", 87, 0, 0, 7, 21, 115
"c:\Users\heave\Documents\GitHub\Computer-Science-30-Captsone-Project\Game\Modules\Furnace\Furnace_Menu.py", "Python", 57, 0, 0, 2, 17, 76
"c:\Users\heave\Documents\GitHub\Computer-Science-30-Captsone-Project\Game\Modules\Main_Game\Initialize_Game.py", "Python", 48, 0, 0, 6, 19, 73
"c:\Users\heave\Documents\GitHub\Computer-Science-30-Captsone-Project\Game\Modules\Main_Game\game_objects.py", "Python", 8, 0, 0, 6, 6, 20
"c:\Users\heave\Documents\GitHub\Computer-Science-30-Captsone-Project\Game\Modules\Main_Game\planet_gameplay.py", "Python", 0, 0, 0, 0, 1, 1
"c:\Users\heave\Documents\GitHub\Computer-Science-30-Captsone-Project\Game\Modules\Menu\Furnace_Menu.py", "Python", 67, 0, 0, 8, 20, 95
"c:\Users\heave\Documents\GitHub\Computer-Science-30-Captsone-Project\Game\Modules\Menu\Planet_Menu.py", "Python", 67, 0, 0, 13, 11, 91
"c:\Users\heave\Documents\GitHub\Computer-Science-30-Captsone-Project\Game\Modules\Menu\Planet_Selection_menu.py", "Python", 41, 0, 0, 2, 7, 50
"c:\Users\heave\Documents\GitHub\Computer-Science-30-Captsone-Project\Game\Modules\Menu\Sell_Menu.py", "Python", 33, 0, 0, 4, 10, 47
"c:\Users\heave\Documents\GitHub\Computer-Science-30-Captsone-Project\Game\Modules\Menu\Shop_Menu.py", "Python", 56, 0, 0, 4, 15, 75
"c:\Users\heave\Documents\GitHub\Computer-Science-30-Captsone-Project\Game\Modules\Menu\Storage_menu.py", "Python", 41, 0, 0, 0, 9, 50
"c:\Users\heave\Documents\GitHub\Computer-Science-30-Captsone-Project\Game\Modules\Menu\Tools_Menu.py", "Python", 52, 0, 0, 7, 17, 76
"c:\Users\heave\Documents\GitHub\Computer-Science-30-Captsone-Project\Game\Modules\Menu\__pycache__\Interactive-1.ipynb", "JSON", 0, 0, 0, 0, 1, 1
"c:\Users\heave\Documents\GitHub\Computer-Science-30-Captsone-Project\Game\Utils\Util_Functions.py", "Python", 44, 0, 0, 2, 13, 59
"c:\Users\heave\Documents\GitHub\Computer-Science-30-Captsone-Project\Game\Utils\Util_Variables.py", "Python", 1, 0, 0, 0, 1, 2
"c:\Users\heave\Documents\GitHub\Computer-Science-30-Captsone-Project\Game\test.md", "Markdown", 0, 0, 0, 0, 1, 1
"c:\Users\heave\Documents\GitHub\Computer-Science-30-Captsone-Project\README.md", "Markdown", 0, 3, 0, 0, 2, 5
"Total", "-", 1203, 102, 0, 114, 317, 1736